R 801 400
NO textures/eagle.xpm
SO textures/greystone.xpm
WE textures/wall_w.xpm
EA textures/wall_e.xpm
S textures/pillar.xpm
F 255, 0, 0
C 0, 0, 125

        1111111111111111111111111
        1000000000110000000000001
        1011000001110000002000001
        1001000000000000000000001
111111111011000001110000000000001
100000000011000001111111111111111
11110111111111011100000000001
11110111111111011101010010201
11000000110101011100000010001
100020200W0000001100000010201
10000000000000000001010010001
1100000111010101111101111000111
11110111 1110101 101111010001
11111111 1111111 111111111111
