R 21474836472 50044
NO texture/wall_n.xpm
SO texture/wall_s.xpm
WE texture/wall_w.xpm
EA texture/wall_e.xpm
S texture/pillar.xpm
F 184, 113, 39
C 51, 198, 25

        11111 11111111111111111111
        10000 00000110000000000001
        10110 00001110000000000001
        10010 00000000000000000001
1111111110110 00001110000000000001
1000000000110 00001111111111111111
1111011111111 1011100000000001
1111011111111 1011101010010001
1100000011012 2011100000010001
100000000000E 0001100000010001
1000000000000 0000001010010001
1100000111010 101111101111000111
11110111 1110 101 101111010001
11111111 1111 111 111111111110
