R 801 400
NO textures/wall_n.xpm
SO textures/wall_s.xpm
WE textures/wall_w.xpm
EA textures/wall_e.xpm
S textures/pillar.xpm
F 184, 113, 39
C 51, 198, 227

111111111111111111111111111111111
101000000001100000000000011111111
101100020111000000200000111111111
1001000E0020000000000000111111111
100000000011000001110000000000001
111111111111111111111111111111111
